Een overzicht van termen en concepten voor het consistent vertalen van Plone naar het Nederlands.

Language: Dutch (nl) - Nederlandsch ;-)

Last maintainer: Fred van Dijk & Maurits van Rees (info@zestsoftware.nl)
Laatst bijgewerkt op: 10 juni 2016

1) Vaak voorkomende woorden en hun standaard vertaling:

       accessibility                  = toegankelijkheid (algemeen)/sneltoetsen (menu)
       acquire                        = verkrijgen
       action                         = actie
       add                            = toevoegen
       add-on Products                = extra producten
       advanced                       = geavanceerd
       apply                          = toepassen
       area                           = gedeelte
       attendees                      = deelnemers
       authentization                 = authenticatie

       behaviors                      = Extra functies
       behavior                       = Functie
       below                          = onder
       broken link                    = ongeldige link
       browse                         = bladeren
       browser                        = browser

       cancel                         = annuleren
       cache                          = cache
       change(s)                      = wijziging(en) (zelfstandignaamwoord)
       checkbox                       = checkbox
       check                          = aanvinken
       click                          = klik
       collection                     = verzameling
       comment                        = opmerking/reactie (afh. van zinsverband)
       configuration, preference      = configuratie, voorkeur
       content                        = content (wanneer gesproken wordt over de verzameling informatie) / inhoud van een pagina
       content rules                  = content-regels
       contents                       = inhoud
       content type                   = contenttype
       control panel                  = instellingenscherm
       cookies                        = cookies
       contributor                    = auteur
       writer                         = redacteur
       editor                         = redacteur
       reviewer                       = eindredacteur
       reader                         = lezer
       creator                        = auteur
       creation date                  = aanmaakdatum
       criteria                       = criteria
       criterion                      = criterium

       date range                     = periode
       default                        = standaard
       delete                         = verwijderen
       detail                         = detail
       description                    = omschrijving/beschrijving (afh. van context)
       disable                        = uitschakelen
       discussion                     = discussie
       display                        = tonen
       (a) duplicate                  = kopie

       edit                           = bewerken
       effect                         = effect
       effective date                 = ingangsdatum
       e-mail (also mail/email)       = e-mail
       enable                         = inschakelen
       end date                       = einddatum
       entry                          = invoer
       event                          = Agenda-item
       events (tab)                   = Agenda
       expire                         = verlopen
       expiration date                = verloopdatum
       external                       = extern

       favorites                      = favorieten
       feed (RSS)                     = RSS feed
       feedback                       = reactie
       file                           = bestand
       firewall                       = firewall
       flip                           = spiegelen (zowel horizontaal als verticaal)
       folder                         = map
       front page                     = startpagina

       group                          = groep

       history                        = geschiedenis
       home                           = home

       image                          = afbeelding
       input                          = invoer
       insufficient privileges        = onvoldoende rechten
       integer                        = geheel getal
       internal                       = intern
       item                           = item

       join                           = registreren

       keyword                        = trefwoord (geen steekwoord)

       line                           = regel
       link                           = link
       list                           = lijst
       listing                        = inhoud/lijst (afh. van context)
       log                            = logboek
       log on                         = inloggen (geregistreerde gebruikers)
       log off                        = uitloggen

       mail                           = e-mail
       Mail Host                      = E-mail server
       manager                        = beheerder
       membership                     = lidmaatschap
       member                         = lid
       metadata                       = metadata
       modification date              = wijzingingsdatum
       modify                         = bewerken

       name                           = naam

       optional                       = optioneel
       overview                       = overzicht
       order                          = volgorde

       page                           = pagina
       panel                          = scherm
       parent                         = bovenliggend
       path                           = locatie (pad)
       permissions                    = rechten
       pending                        = Ingediend
       pixel                          = pixel
       please                         = alstublieft
       Plone                          = Plone
       policy                         = beleid
       portal type                    = contenttype
       portlet                        = portlet
       portrait                       = pasfoto
       to post                        = plaatsen
       preferences                    = voorkeuren
       print                          = afdrukken
       private                        = privÃ©
       privileges                     = rechten
       properties                     = eigenschappen
       proxy                          = proxy
       public draft                   = concept
       publishing history             = publicatiegeschiedenis
       publishing                     = publiceren

       refresh                        = verversen
       reference                      = verwijzing
       reject                         = afwijzen
       relative date                  = datum t.o.v.
       remove                         = verwijderen
       reply                          = antwoord
       required                       = verplicht
       resource                       = bron
       retract                        = terugtrekken
       reviewer                       = eindredacteur
       to review                      = redigeren
       rights                         = rechten
       richtext                       = tekst met opmaak
       rotate                         = draaien

       save                           = opslaan
       search                         = zoeken
       section                        = sectie
       set up                         = instellingen
       settings                       = instellingen
       sharing permissions            = rechten
       show                           = tonen
       site                           = website
       simple int                     = geheel getal
       simple string                  = term
       skin                           = stijl
       smart folder                   = verzameling
       collection                     = verzameling
       specify                        = geef aan
       start date                     = startdatum
       state                          = status
       sub...                         = sub...
       subfolder                      = submap
       subject                        = onderwerp  (let op, trefwoorden staan ook in het subjects veld)
       submit                         = indienen voor publicatie (in relatie tot publicatie proces)
       submit                         = Versturen (in relatie tot formulieren verzenden)
       syndication                    = RSS feed

       template                       = sjabloon
       theme                          = thema
       title                          = titel
       toggle                         = aan-/uitvinken
       tool                           = tool/hulpmiddel
       traceback                      = kruimelpad
       transaction                    = bewerking
       transactional feature          = knop ongedaan maken
       transcript                     = logboek
       transform (image)              = aanpassen
       type                           = contenttype

       undo                           = ongedaan maken
       uncheck                        = uitvinken
       unique                         = uniek
       unsuccesful                    = niet geslaagd
       update                         = bijwerken
       upload                         = upload
       URL                            = internetadres
       user                           = gebruiker

       validation                     = controle
       value                          = waarde
       view                           = bekijken (op een tabblad)
       view                           = tonen/weergeven (afh. van zinsverband)
       view                           = view (browser view)
       visible                        = zichtbaar
       vocabulary                     = woordenlijst

       web site                       = website
       web                            = internet
       window                         = venster
       workflow                       = publicatieproces

2) Liever niet:

       steekwoorden,sleutelwoorden   -> trefwoorden
       verandering                   -> wijziging
       verlopen                      -> vervallen
       verloopdatum                  -> vervaldatum
       publicatiedatum               -> ingangsdatum
       historie                      -> geschiedenis
       internetkoppeling             -> link
       succesvol                     -> geslaagd
       printen                       -> afdrukken
       sortering, sorteervolgorde    -> volgorde
       bewaren                       -> opslaan
       contenttypen                  -> contenttypes (typen is ook een werkwoord)
       afbreken/afgebroke            -> geannuleerd
       aanmelden                     -> inloggen

3) Lastige vertalingen:

* widget

* checkin /checkout bij plone.app.iterate

